SO caca.xpm
NO pipi.xpm
EA lol.xpm
WE ahah.xpm
F 255.255.255
C 255.255.255

   1111
1111001
111100111111
   1000111
   1111111