SO textures/mur.xpm
NO textures/mur.xpm
EA textures/mur.xpm
WE textures/mur.xpm
F 255.255.255
C 255.255.255

   1111
1111001
10000011111
11110N0001
   1111111

